{
	tileset: {
		file: "overworld.tileset.json",		
	},
	width: 20,
	height: 16,
	base_tile: grass, // Hack.
	
	aliases: {
		0: base_grass,
		1: tree_ul,
		2: tree_ur,
		3: tree_dl,
		4: tree_dr,
		5: hole,
	},
	
	tiles: [
		[4,3,4,3,4, 3,4,3,4,3, 4,3,4,3,4, 3,4,3,4,3],
		[2,0,0,0,0, 0,0,0,0,0, 0,0,0,0,0, 0,0,0,0,1],
		[4,0,0,0,0, 0,0,0,0,0, 0,0,0,0,0, 0,0,0,0,3],
		[2,0,0,0,0, 0,0,0,0,0, 0,0,0,0,0, 0,0,0,0,1],
		[4,0,0,0,0, 0,0,0,0,0, 0,0,0,0,0, 0,0,0,0,3],
		[2,0,0,0,0, 0,0,0,0,0, 0,0,0,0,0, 0,0,0,0,1],
		
		[4,0,0,0,0, 0,0,0,0,0, 0,0,0,0,0, 0,0,0,0,3],
		[2,0,0,0,0, 0,0,0,0,0, 0,0,0,0,0, 0,0,0,0,1],
		[4,0,0,0,0, 0,0,0,0,0, 0,0,0,0,0, 0,0,0,0,3],
		[2,0,0,0,0, 0,0,0,0,0, 0,0,0,0,0, 0,0,0,0,1],
		[4,0,0,0,0, 0,0,0,0,0, 0,0,0,0,0, 0,0,0,0,3],
		[2,0,0,0,0, 0,0,0,0,0, 0,0,0,0,0, 0,0,0,0,1],
		
		[4,0,0,0,0, 0,0,0,0,0, 0,0,0,0,0, 0,0,0,0,3],
		[2,0,0,0,0, 0,0,0,0,0, 0,0,0,0,0, 0,0,0,0,1],
		[4,0,0,0,0, 0,0,0,0,0, 0,0,0,0,0, 0,0,0,0,3],
		[2,0,0,0,0, 0,0,0,0,0, 0,0,0,0,0, 0,0,0,0,1],
		[4,0,0,0,0, 0,0,0,0,0, 0,0,0,0,0, 0,0,0,0,3],
		[2,1,2,1,2, 1,2,1,2,1, 2,1,2,1,2, 1,2,1,2,1],
	],
}